==================================================
=------------=================----=====----------=
=---===------------======----------------=====---=
===========------------------=============-------=
=------------==============--------------------===
=--==========---------------=======--======------=
=---------------========--=========-==============
========================-------------------------=
=----------------------------===========---------=
=---===================--=----------======-------=
=---=-------====---------========---=====--------=
=--==--------------------=----------=------------=
=--==----===-----===========--=======------------=
=--------========-----------------------==========
==========------------==============-------------=
=---------------====-------=--------==============
=------==-------==----===-----===----------------=
=--=========-----------------==============------=
=------------------==----==----------------------=
======================88==========================
